@.//./../../.././././/./../
../../...../..//..././/./..
..-........................
.......././.../....././....
...........................
.././..//....././././../-./
..../.....-./../....-......
-..........-...............
./..../....///././/./////./
...........................
...........................
...////.../.././/..///..../
/../.../..///.....///......
./..///.....//././//..//...
/...././........../.../.../
../........../......../../.
...........................
..................//../....
...........................
...........................
