@..........................
.../....../..//./.....././.
........./../......./......
...././/........../.././...
/......../..././..././.././
.-...........-.............
...././//.../../././//.../.
...../..//.................
....//.././/./.....///.././
...........................
.-.........................
...........................
...........................
....../........../.........
//.././..//..././..//.//.//
..../............../....../
/....//./......./..../.....
/./.../....../../........./
...........................
//.///././///.......///../.
