@/./...///........././././.
..../..../........../......
........................-..
...........................
.../.................././..
............../............
...........................
...../................../..
//././//../../..../....///.
/.../..//..../././/.//////.
........./..//.......//..//
........../....../.........
..../....///.//./././//..//
............../...../...-..
........-..................
......../..................
....././....../../././/.../
...........................
...........................
...........................
