@////./.../-./////././.../.
./......//./..//../..//.../
................//.........
....//../.........../......
....-..................-...
...././....././...//.......
...../../..../-....../.....
../............./.......///
...........................
...........................
........-.............-....
............./.............
...........................
...........................
...........................
/....//./..././../../..//..
.......-...................
................../........
//../.....././///..../////.
.../......//...././././....
