@..........................
../...../..........-...../.
...../....../.../.././/....
//..//..//..//.....//////..
...........................
.///.//../.././...//.../../
/........../............../
....//.....................
...........................
././........//........////.
.....................././..
.././///////..//./....//..-
...........................
/..///..././././/./..//././
/..////../././././/.../../.
...........................
..........................-
...........................
///.../....//..//..././/./.
./......./.././..//...////.
