@/../././../..//../....//./
......../../.././.../......
//.././/.//./././/.././....
..../......././/....//..../
/.././/./..//./././././.../
...........................
.....//..././//..-....-..//
///.///.........//./././../
........./..../......./....
..........................-
././....../.....//..//./...
.................../.......
././/-////...../././/.///./
..././../...//..../.../....
//......./..../...../......
...........................
//../.../...././../..././//
..//../..../.../....../....
...........................
.....-....-....../.........
