@..........................
/.-./..//...././///.././/./
./../-....../.../..........
/.//./..///.//./..../-//./.
......../..................
.///.////...-/.../.../.../.
././/........./.....-.//../
...........................
/./..//.//.....////./...///
..........//../..../.......
//...//.......././....//.//
...........................
.../......../....-....-../.
//././/.....////./../.././/
/./../././.../.../......./.
..//.../.././..///..../....
...../.....................
........./............/....
/........../...............
........../././/./.../.../.
