@..........................
..././/././/.....///...///.
././.......//....../..../..
.................../..//../
......//.../...............
...........................
./................/........
......./...................
....-......................
........././/..............
.....-.......-.............
...........................
../............./...-......
....././...............//..
.././..//..././/./.......//
........../..//.....//...//
//./.../.././//./..........
.//...../..../////./////../
.......///.././/./././/////
...........................
