@..........................
././//../..-.////.-...././/
.//.../../.....././...././.
/........./.../.././.......
..././..//..//././..///.../
...//././././/...././..////
.../........./../.........-
/./....././/./...///../..//
.......//............././/.
...........................
................./.........
/..../.................../.
...........................
.....-..........-..........
....../......-....-..../...
.//..//.././///..//....../.
....///.//..../....././....
....../......./......../...
-........................-.
...........................
