@/.//./..-//.././...././//.
...........................
../..//....//...//.//...../
...........................
--.........................
...........................
./...-.....................
///.///..//-...-/.////.../.
...........................
...........................
...-/..../....//........../
...........................
....././///..//../..../././
...........................
........./.........../.....
...........................
./../...//../././//./////..
...........................
./..././/./././.././..../..
..../..././...//.//........
