@..........................
/.......///.//.......///.-.
...........................
............../............
...........................
....../......../........../
..//.//.....//./..././.....
/./..../././/././///..../.-
.././..././//....//../../..
...........................
././././//./..////./....//.
...../.................../.
............-..............
...........................
......-.................-..
//.../....//..../././/.....
............/..../...../...
........../.../............
............-.........-....
/.//...//./..//.//./.....//
