@/......../.././......../..
..///.//........../....//./
...........................
...........................
...././/./...././///..///..
.........///....././/......
....-.......././..//../../.
...........................
./...//../.../././.../.././
////.....././...../../././.
/.////.//./..././..././/./.
...........................
...............-...........
../....../..///../.../.....
.././..../.........../../..
.../..........././.........
.......................-...
...././../../...///..-.../-
/.///..//..../.../-/.////./
./....///..//..//.//.././..
