@..........//././.....-//..
......./../......../.......
///./././....//././..///./.
..///...//.../././..-../.-.
/../....-..................
......//./../..............
...........................
..../../.../././..//././...
/....-/.///.//....///..///.
...........................
..-.............-..........
..../...//.//..../.........
../..././//./../....-......
.///....../.../....//./../.
./.......././.../.../..../.
.........../...............
..........././..../../..../
...........................
...........................
...........................
