@..........................
.......................-...
./......./.-........//..//.
..../...././../..././//////
...........................
//....././/../..././//.././
/....////..///./...///.././
...........................
.///.//../....///////..../.
..............-............
/....//..///....../....../.
////..//.//..///../..//../.
...../....../../...........
......../....//./.....////.
../.../...//.///....../././
...........................
......../........./../.....
...........................
/............./.....//.....
................//.........
