@..........................
../-/.././//../.....-///../
./..../..//./..//....../../
/....../././//.//....//.../
/.../..././.../............
./......./.../...../.......
...........................
..--.......................
...........................
...........................
....................../....
...............-...........
...........................
.//.-/................-....
...........................
.//./../....///.....//./...
//.//././//.//////.../.....
/./../../././.....///.///..
.//.././/./.-..../////..//.
...../........//....././../
