@...............-..........
.-......-..................
..././...../././././/.//./.
/./...////........./../..//
../..../................/..
...........................
...........................
./..../.../././/../........
...........................
...........................
-/././../../...-././///..//
...........................
............/..............
//./...../........../..//..
..../......................
//.//../////..//./.../..../
///./....///......../.../..
...//../..///./..//........
//./......./..///./../..//.
...........................
