@...././.././.........//...
....../..../.../../.../....
../../..//.//......//..../.
...//.........//..//.../...
...........................
./-./../..././//.//.../...-
./..///..-/.../././//..//./
...........................
...........................
...........................
./.........../../..........
.//...//./.......-//..//./.
.///...//....././..////././
././.././//.////.../..///..
...........................
...........................
./..././...././......../...
...........................
...........................
./.../......./../......./..
