@/....../......../.../../..
./..../.........-......./-/
............../....../.....
.-.///..///-........///.//.
..//.//../...../..../...../
...........................
...........................
...-.......................
...........................
././/.//.///..../././////..
...........................
...........................
.................../....../
...../././....//.//..././//
........../..//...////../..
././//...--........./......
........................///
...........................
..//...//.....//...../.....
..//.../............./.../.
