@..........................
...........................
...../..//-...../../../.../
././/.....-...//../../..../
./.././../-..../..../..../.
.........................-.
/./////.//./..//..///......
...........................
......./.../........-.....-
..//...././...//.....//....
../............././/..//...
../././..///./../-.////././
./.../........./.././......
.////..../../.....////./../
...........................
/../..../...///.//..././//.
../...././.....././../../..
./...//////..//./././..../.
..../.........//.....//....
...........................
