@././/.////./././/......//.
...........................
/..-.//.///.//../..///..//.
///..../....//..//.//..../.
..-..////...////./..././//.
//././..../......-../.././.
........./....././../.-.../
......-....................
...//....////........./.../
.././/..//..///...../././/.
...........................
./..........//.../....../..
/...////.///./...././/.//..
..../......................
./.../../..//.../././/../..
/........../............../
...../.................../.
..../................./....
../../....//../............
..//........./......../..//
