@/////-.....////../..././/.
././/.///././/././/..././..
......-............-.......
.../..../..................
..........././..//.........
.-.........................
...........................
.../.../../././////////..//
////////./../.-/..//...//..
//./..../......./...//..//.
....................../....
./.-//././...//...././././.
../......//......////.././.
........................./.
...........................
...................//......
...........................
/.....//..//..././...../../
/.///..//.....//...../...//
/.../....../............./.
