@./...///....././.../......
./...-..../..../.-......./.
.........--................
./../././../...///./....//.
..../..../.................
/.../....//.//.//-/././..//
..../../.......././..//....
......//..../...//././.../.
.......-...................
..-/....//.../.../...//....
...........................
//..././/.//.//.//../.../..
.../.......................
...........................
.../././..././/.//..//./../
/.....//././/..//.//.//../.
/././/.//..//..//...//./../
/......./..../.........../.
./..////...//...//./.......
...........................
