-....../../...//.././/.....
..../../../.....-.///......
.........-........../......
....///............./......
//../.../............././..
../../.../..../......././..
.....//../.................
....../../..@.......//.....
.//../............/....../.
....-..../...//..//./..../.
//./...///..././..///../../
.....//.//.../../....//./..
....//........//../../././.
..//...///./........-......
../..../../................
....................-......
....../../...//............
///..////.//./././/..../../
...........................
../.........../........./..
