@.//....../..-....-.../../.
/..//........//./././././/.
/..........................
...........................
......//././.../././/...-./
.///..////./..//../.././/..
................/.....-....
..//..////.../.././/../../.
./././/../..././././/../...
.........-.......-.........
...../.../../.........///./
../...../......./....//....
..........-................
//.././..//.../..././//.//.
......./........./.........
...........................
....//....././../........./
..../..../.../...../..../..
//../..../.././///....././.
...........................
