...........................
...........................
...........................
.............@.............
...........................
...........................
........../////............
...........................
..........-.......././.....
..........-.......././.....
..........-.......././.....
..........-.......././.....
..........-.......././.....
..........-................
..........-................
..........-................
..........-................
..........-................
................./.........
................./////.....