@../.....///.....-./../....
../..//.////..//.././//./..
..////./....././..../.././/
...........-...............
....././......../../....../
.-.........................
...../../........./.../....
..//.../.../....../..//....
.../..../.../......../..../
./.........///..../..//.///
../...../....././...../../.
./../../..../.././//...././
/../../......../......../..
...........................
..//././........./.........
././//..../.....././//.....
..././/.......././/./././//
...........................
................/...../....
/././//......./././//////..
