-....../../...//.././/.....
..../../../.......///......
..-................./......
....///............./......
//../.../.........-..././..
../../.../..../......././..
.....//../.................
....../../..@.......//.....
.//../............/....../.
........./...//..//./..../.
//-/...///..././..///../../
.....//.//.../../....//./..
....//........//../../././.
..//...///./...............
../..../../................
...........................
....../../...//............
///..////.//./././/..../../
....-...............-......
../.........../........./..
